254 254 251 251 254 254 254 254 254 254 254 254 254 254 254 254
254 254 251 251 254 254 254 254 254 254 254 254 254 254 254 254
254 254 251 251 251 251 251 251 251 251 251 251 251 251 251 251
254 254 251 251 251 251 251 251 251 251 251 251 251 251 251 251
254 254 251 251 251 251 251 251 251 251 251 251 251 251 251 251
254 254 251 251 168 169 251 251 168 169 251 251 168 169 251 251
254 254 251 251 178 179 251 251 178 179 251 251 178 179 251 251
254 254 251 251 251 251 251 251 251 251 251 251 251 251 251 251
254 254 251 251 251 251 251 251 251 251 251 251 251 251 251 251
254 254 251 251 251 251 251 251 251 251 251 251 251 251 254 254
254 254 254 254 254 254 254 254 254 254 254 254 251 251 254 254