164 164 251 251 251 251 251 251 251 251 251 251 251 251 254 254
164 164 251 168 169 251 168 169 251 251 251 251 251 251 254 254
164 164 251 178 179 251 178 179 251 251 251 251 251 251 254 254
164 164 161 161 161 161 161 161 161 161 161 161 161 161 254 254
164 164 161 161 161 161 161 161 161 161 161 161 161 161 254 254
164 164 161 108 109 161 108 155 161 161 161 161 161 161 161 161
164 164 161 164 164 161 164 164 155 161 161 161 161 161 161 161
164 164 161 164 164 161 164 164 164 155 161 161 161 161 161 161
164 164 161 164 164 161 164 164 164 164 155 161 161 161 161 161
164 164 164 164 164 164 164 164 164 164 164 164 164 164 164 164
164 164 164 164 164 164 164 164 164 164 164 164 164 164 164 164