164 164 164 164 164 164 164 164 164 164 164 164 164 164 164 164
164 164 164 164 164 164 164 164 164 164 164 164 164 164 164 164
164 164 164 164 164 164 164 164 164 175 161 161 161 161 161 161
164 164 164 164 164 164 164 164 175 161 161 161 161 161 161 161
164 164 164 164 164 164 161 161 161 161 161 161 161 161 161 161
164 164 164 164 164 175 161 161 161 161 161 161 161 161 161 161
164 164 164 164 175 161 161 161 161 161 161 161 161 161 161 161
164 164 164 175 161 161 161 161 161 161 161 161 161 161 161 161
164 164 175 161 161 161 161 161 161 161 161 161 161 161 161 161
164 164 116 161 161 161 161 161 161 161 161 161 161 161 161 161
164 164 161 161 161 161 161 161 161 161 161 161 161 161 161 161