164 164 164 164 164 164 164 164 161 161 161 161 161 161 161 161
164 164 164 164 164 150 161 161 161 028 044 044 044 044 035 161
164 164 106 161 161 161 161 161 039 044 044 044 044 044 044 044
164 164 161 161 161 161 028 044 044 044 044 044 044 044 044 044
164 164 161 161 161 161 044 044 044 044 044 044 044 044 044 044
164 164 161 161 161 161 038 044 044 044 044 044 044 044 044 044
164 164 155 161 161 161 161 161 161 161 161 161 038 044 044 044
164 164 164 155 161 161 161 161 161 161 161 161 161 161 161 161
164 164 164 164 164 164 164 164 164 109 161 161 161 161 161 161
164 164 164 164 164 164 164 164 164 164 164 164 164 164 164 164
164 164 164 164 164 164 164 164 164 164 164 164 164 164 164 164