254 254 254 254 254 254 254 254 254 254 254 254 254 254 254 254
254 254 254 254 254 254 254 254 254 254 254 254 254 254 254 254
251 251 251 251 242 254 254 254 254 254 254 240 251 251 251 251
251 251 251 251 251 242 254 254 254 254 240 251 251 251 251 251
251 251 251 251 251 251 242 254 254 240 251 251 251 251 251 251
251 251 251 251 251 251 251 251 251 251 251 251 251 251 251 251
251 251 251 251 251 251 262 254 254 260 251 251 251 251 251 251
251 251 251 251 251 262 254 254 254 254 260 251 251 251 251 251
251 251 251 251 262 254 254 254 254 254 254 260 251 251 251 251
254 254 254 254 254 254 254 254 254 254 254 254 254 254 254 254
254 254 254 254 254 254 254 254 254 254 254 254 254 254 254 254