254 254 254 254 254 254 254 254 254 254 254 254 254 254 254 254
254 254 254 254 254 254 254 254 254 254 254 254 254 254 254 254
251 251 251 254 254 254 254 254 254 254 254 254 254 254 254 254
251 251 251 254 254 254 254 254 254 254 254 254 254 254 254 254
251 251 251 254 254 254 254 254 254 254 254 254 254 254 254 254
251 251 251 251 251 251 251 251 251 251 251 251 251 251 254 254
251 251 251 251 251 251 251 251 251 251 251 251 251 251 254 254
251 251 251 251 251 251 254 251 254 251 254 251 254 251 254 254
251 251 251 251 251 251 251 251 251 251 251 251 251 251 254 254
254 254 254 254 254 254 254 254 254 254 254 254 254 254 254 254
254 254 254 254 254 254 254 254 254 254 254 254 254 254 254 254