254 254 254 254 254 254 254 254 254 254 254 254 254 254 254 254
254 254 254 254 254 254 254 254 254 254 254 254 254 254 254 254
254 254 254 254 254 254 254 254 254 254 254 254 254 254 254 254
254 254 254 254 254 254 254 254 254 254 254 254 254 254 254 254
254 254 254 254 254 254 254 254 254 254 254 254 254 254 254 254
161 161 161 161 161 161 161 161 161 161 161 161 161 108 164 164
161 161 161 161 161 161 161 161 161 161 161 161 161 164 164 164
161 161 161 161 161 161 161 161 161 161 161 161 161 164 164 164
161 161 161 161 161 161 108 164 164 109 161 161 161 164 164 164
164 109 161 161 161 161 164 164 164 164 161 161 161 164 164 164
164 164 161 161 161 161 164 164 164 164 161 161 161 164 164 164