161 161 161 161 161 161 161 161 161 161 161 161 161 161 161 161
161 161 161 161 161 161 161 161 161 161 161 161 161 161 161 161
161 161 161 161 161 161 161 161 161 161 161 161 161 161 161 161
161 161 161 161 161 161 161 161 161 161 161 161 161 161 161 161
164 164 164 109 161 161 161 161 161 161 161 161 033 044 044 044
164 164 164 164 161 161 161 161 028 044 044 044 044 044 044 044
044 044 044 044 044 044 044 044 044 044 044 044 044 044 044 044
044 044 044 044 044 044 044 044 044 044 044 044 044 044 044 044
161 161 161 161 161 053 044 044 044 044 044 044 044 044 044 044
161 161 161 161 161 161 053 044 044 044 044 044 044 044 044 044
161 161 161 161 161 161 161 053 044 044 044 044 044 044 044 044