161 161 161 161 161 161 161 161 053 044 044 044 044 044 044 044
161 161 161 161 161 161 161 161 161 053 044 044 044 044 044 044
044 044 044 029 161 161 161 161 161 161 053 044 044 044 044 044
044 044 044 044 161 161 161 161 161 161 161 053 044 044 044 044
044 044 044 044 161 161 161 161 161 161 161 161 161 161 118 164
044 044 044 044 161 161 161 161 161 161 161 161 161 161 161 161
044 044 044 039 161 161 161 161 161 161 161 161 161 161 161 161
161 161 161 161 161 161 161 172 164 164 170 161 161 161 161 161
161 161 161 161 161 161 172 164 164 164 164 164 170 161 161 161
164 164 164 164 164 164 164 164 164 164 164 164 164 164 164 164
164 164 164 164 164 164 164 164 164 164 164 164 164 164 164 164