254 254 254 254 254 254 254 254 254 254 251 251 254 254 254 254
254 254 254 254 254 254 254 254 254 254 251 251 254 254 254 254
251 251 251 251 251 251 251 251 251 251 251 251 251 251 251 251
251 251 251 251 251 251 251 251 251 251 251 251 251 251 251 251
251 251 251 168 254 169 251 168 254 169 251 251 251 251 251 251
251 251 251 254 254 254 251 254 254 254 251 251 251 251 251 251
251 251 251 178 254 179 251 178 254 179 251 251 251 251 251 251
251 251 251 251 251 251 251 251 251 251 251 251 251 251 251 251
251 251 251 251 251 251 251 251 251 251 251 251 251 251 251 251
254 254 254 254 254 254 254 254 254 254 254 254 254 254 254 254
254 254 254 254 254 254 254 254 254 254 254 254 254 254 254 254