254 254 254 254 254 254 254 254 254 254 254 254 254 254 254 254
254 254 254 254 254 254 254 254 254 254 254 254 254 254 254 254
254 254 251 251 251 251 251 251 251 251 251 251 251 251 254 254
254 254 251 008 004 004 004 004 004 004 004 004 009 251 254 254
254 254 251 013 014 014 014 014 014 014 014 014 015 251 254 254
254 254 251 013 014 014 014 014 014 014 014 014 015 251 254 254
254 254 251 018 024 024 024 024 024 024 024 024 019 251 254 254
254 254 251 251 251 251 251 251 251 251 251 251 251 251 254 254
254 254 251 168 169 251 251 251 251 251 251 168 169 251 254 254
254 254 251 178 179 251 251 251 251 251 251 178 179 251 172 164
254 254 251 251 251 251 251 251 251 251 251 251 251 251 164 164