254 254 251 251 251 251 251 251 251 251 251 251 251 251 164 164
254 254 251 251 251 251 251 168 169 251 251 251 251 251 164 164
254 254 251 251 251 251 251 178 179 251 251 251 251 251 164 164
254 254 161 161 161 161 161 161 161 161 161 161 161 161 164 164
254 254 161 161 161 161 161 161 161 161 161 161 161 161 118 164
164 164 109 161 161 161 161 161 161 161 161 161 161 161 161 161
164 164 164 161 161 161 161 161 161 161 161 161 161 161 161 161
164 164 164 161 161 161 161 161 161 161 161 161 161 161 161 161
164 164 164 161 161 161 161 161 161 161 161 161 161 161 161 161
164 164 164 164 164 164 164 164 164 164 164 164 164 164 164 164
164 164 164 164 164 164 164 164 164 164 164 164 164 164 164 164