164 164 164 164 164 164 164 164 164 164 164 164 164 164 164 164
164 164 164 164 164 164 164 164 164 164 164 164 164 164 164 164
164 164 164 164 164 164 164 164 164 164 164 164 164 164 164 164
164 164 164 164 164 164 164 164 164 164 164 164 164 164 164 164
161 173 164 164 164 164 164 164 164 164 164 164 164 164 164 164
161 161 161 161 161 161 161 161 161 161 161 161 161 161 161 161
161 161 161 161 161 161 033 044 044 044 044 044 044 044 044 044
161 161 161 161 028 044 044 044 044 044 044 044 044 044 044 044
161 161 161 161 044 044 044 044 026 161 161 161 161 161 161 161
161 161 161 161 044 044 044 044 161 161 161 161 161 161 161 161
161 161 161 161 044 044 044 044 161 161 161 161 161 161 108 164