161 161 161 161 044 044 044 044 161 161 161 161 161 161 118 164
161 161 161 161 044 044 044 044 161 161 161 161 161 161 161 161
161 161 161 033 044 044 044 044 161 161 161 161 161 161 161 161
161 161 033 044 044 044 044 044 161 161 161 161 161 161 161 161
044 044 044 044 044 044 044 044 161 161 161 161 161 161 161 161
044 044 044 044 162 162 162 162 161 161 161 161 161 161 161 161
044 044 044 044 162 162 162 162 161 161 161 161 161 161 161 161
044 044 044 044 044 044 044 044 161 161 161 161 161 161 161 161
044 044 044 044 044 044 044 044 161 161 161 161 161 161 161 161
044 044 044 044 044 044 044 044 164 164 155 161 161 161 161 161
044 044 044 044 044 044 044 044 164 164 164 164 164 164 164 164