044 044 044 044 044 044 044 055 164 164 164 164 164 164 164 164
044 044 044 044 044 044 055 164 164 164 164 164 164 164 164 164
044 044 044 044 044 055 164 164 164 164 164 164 164 164 164 175
044 044 044 044 055 164 164 164 164 164 164 164 164 175 161 161
164 164 164 164 164 175 161 161 161 161 161 161 161 161 161 161
161 161 118 164 119 161 161 161 161 161 161 161 161 161 161 161
161 161 161 161 161 161 161 161 161 161 161 161 161 161 161 161
161 161 161 161 161 161 161 161 161 161 161 161 161 161 153 164
161 161 161 161 161 161 161 108 109 161 161 161 161 161 164 164
164 164 164 164 164 164 164 164 164 164 164 164 164 164 164 164
164 164 164 164 164 164 164 164 164 164 164 164 164 164 164 164