254 254 251 251 254 254 254 254 254 254 254 254 254 254 254 254
254 254 251 251 254 254 254 254 254 254 254 254 254 254 254 254
254 254 251 251 251 251 251 251 251 251 251 251 251 251 251 251
254 254 251 251 254 251 251 251 251 251 251 251 251 251 251 168
254 254 251 251 254 251 251 251 251 251 251 251 251 251 251 254
254 254 251 251 254 254 254 254 251 254 254 254 254 251 251 254
254 254 251 251 251 251 251 251 251 251 251 251 254 251 251 254
254 254 251 251 251 251 251 251 251 251 251 251 254 251 251 178
254 254 251 251 251 251 251 251 251 251 251 251 251 251 251 251
164 164 164 164 164 164 164 164 164 164 164 164 164 164 161 161
164 164 164 164 164 164 164 164 164 164 164 164 164 164 161 161