164 164 164 164 164 164 164 164 164 164 164 164 161 161 164 164
164 164 164 164 164 164 164 164 164 164 164 164 161 161 152 164
164 164 164 164 164 164 164 164 164 164 164 164 161 161 161 161
164 164 164 164 164 164 164 164 164 164 164 164 161 161 161 161
164 164 164 164 164 106 107 164 164 164 164 164 161 161 161 161
161 161 161 161 161 161 161 173 164 164 164 037 044 044 044 044
044 044 044 044 044 044 044 044 044 044 044 044 044 044 044 044
044 044 044 044 044 044 044 044 044 044 044 044 044 044 044 044
161 161 161 161 161 161 161 161 161 161 161 161 161 161 161 161
161 161 161 161 161 161 161 161 161 161 161 161 161 161 161 161
164 164 164 164 164 164 164 164 164 164 164 164 164 164 164 164