164 164 164 164 164 164 164 164 161 161 161 161 161 161 164 164
164 164 164 164 164 175 161 161 161 161 161 161 161 161 173 164
161 161 161 161 161 161 161 161 161 161 161 161 161 161 161 164
161 161 161 161 161 161 161 161 161 161 161 161 161 161 161 161
161 161 161 161 161 108 164 164 164 164 109 161 161 161 161 161
161 161 161 161 161 164 164 164 164 164 164 161 161 161 161 161
161 161 161 161 161 118 164 164 164 164 119 161 161 161 161 161
164 170 161 161 161 161 161 161 161 161 161 161 161 161 161 161
164 164 161 161 161 161 161 161 161 161 161 108 109 161 161 161
164 164 164 164 164 164 164 164 164 164 164 164 164 164 164 164
164 164 164 164 164 164 164 164 164 164 164 164 164 164 164 164