254 254 254 254 254 254 254 254 254 254 254 254 254 254 254 254
254 254 254 254 254 254 254 254 254 254 254 254 254 254 254 254
251 251 251 251 251 251 251 251 251 251 251 251 251 251 251 251
251 251 284 284 284 284 284 251 251 251 251 251 251 251 251 251
251 251 284 284 284 284 284 251 251 251 251 251 251 251 251 251
251 251 284 284 284 284 284 251 251 251 251 251 251 251 251 251
251 251 284 284 284 284 284 251 251 251 251 251 251 251 251 251
251 251 284 284 284 284 284 251 251 251 251 251 251 251 251 251
251 251 251 251 251 251 251 251 251 251 251 251 251 251 251 251
254 254 254 254 254 254 254 254 251 251 251 251 251 251 251 251
254 254 254 254 254 254 254 254 251 251 251 251 251 251 251 251