254 254 254 254 251 251 254 254 254 254 254 254 254 254 254 254
254 254 254 254 251 251 254 254 254 254 254 254 254 254 254 254
251 251 251 251 251 251 251 251 251 251 254 254 254 254 254 254
254 251 251 251 251 251 251 251 251 251 254 254 254 254 254 254
254 251 251 251 251 251 251 251 284 251 254 254 254 254 254 254
254 251 251 251 251 251 251 251 251 251 254 254 254 254 251 251
254 251 251 251 251 251 251 251 251 251 254 254 254 254 251 251
254 251 251 251 251 251 254 254 254 254 254 254 254 254 251 251
251 251 251 251 251 251 254 254 254 254 254 254 254 254 251 251
161 161 164 164 164 164 164 164 164 164 164 164 164 164 161 161
161 161 164 164 164 164 164 164 164 164 164 164 164 164 161 161