161 161 164 164 164 164 164 164 164 164 164 164 164 164 161 161
161 161 164 164 164 164 164 164 164 164 164 164 164 164 161 161
161 161 164 164 161 161 161 161 161 161 161 161 164 164 161 161
161 161 152 150 161 161 161 161 161 161 161 161 152 150 161 161
161 161 161 161 161 161 161 161 161 161 161 161 161 161 161 161
161 161 161 161 161 161 172 164 164 170 161 161 161 161 161 161
161 161 161 161 161 172 164 164 164 164 170 161 161 161 161 161
161 161 161 161 161 161 161 161 161 161 161 161 161 161 161 161
161 161 161 161 161 161 161 161 161 161 161 161 161 161 161 161
164 164 161 161 161 161 161 161 052 044 044 044 044 044 044 044
164 164 161 161 161 161 161 161 044 044 044 044 044 044 044 044