164 164 161 161 161 161 161 161 044 044 044 044 044 044 044 044
164 164 161 161 161 161 161 033 044 044 044 044 044 044 044 044
161 161 161 161 161 161 033 044 044 044 044 044 044 044 044 044
161 161 161 161 161 033 044 044 044 044 044 044 044 044 044 044
161 161 161 161 033 044 044 044 044 044 044 044 044 044 044 044
044 044 044 044 044 044 044 044 044 044 044 044 044 044 044 044
044 044 044 044 044 044 044 044 044 044 044 044 044 044 044 044
044 044 044 044 044 044 044 044 044 044 044 044 044 044 044 044
161 161 161 161 161 161 161 161 161 161 161 161 161 161 161 161
161 161 161 161 161 161 161 161 161 161 161 161 161 161 164 164
164 155 161 161 161 161 161 161 161 161 161 161 161 161 164 164