164 175 161 161 161 161 161 161 161 161 161 161 161 161 164 164
161 161 161 161 161 161 161 161 161 161 161 161 161 161 164 164
161 161 161 161 161 161 161 161 161 161 161 161 161 161 161 161
161 161 161 161 161 161 161 161 161 161 161 161 161 161 161 161
161 161 161 161 161 161 161 161 161 161 161 161 161 161 161 161
161 161 161 161 161 161 153 154 154 155 161 161 161 161 161 161
161 161 161 161 161 161 164 164 164 164 155 161 161 161 161 161
161 161 161 172 164 164 164 164 164 164 164 164 164 164 164 164
161 161 172 164 164 164 164 164 164 164 164 164 164 164 164 164
161 172 164 164 164 164 164 164 164 164 164 164 164 164 164 164
164 164 164 164 164 164 164 164 164 164 164 164 164 164 164 164