251 251 254 254 254 254 254 254 254 254 254 254 254 254 251 251
251 251 254 254 254 254 254 254 254 254 254 254 254 254 251 251
251 251 254 254 254 254 254 254 254 254 254 254 254 254 251 251
251 251 251 251 251 251 251 251 251 251 251 251 251 251 251 251
251 251 251 251 251 251 003 044 044 044 044 044 044 044 044 044
251 251 251 251 251 022 044 044 044 044 044 044 044 044 044 044
251 251 251 251 003 044 044 044 044 044 044 044 044 044 044 044
251 251 251 022 044 044 044 044 044 044 044 044 044 044 044 044
251 251 251 044 044 044 044 044 044 044 044 044 044 044 044 044
251 251 251 044 044 044 044 044 044 044 044 025 251 251 251 251
251 251 251 044 044 044 044 044 044 044 000 251 251 251 251 251