251 251 251 044 044 044 044 044 044 044 251 251 251 251 251 251
251 251 251 044 044 044 044 044 044 044 251 251 251 251 251 251
251 251 251 044 044 044 044 044 044 044 251 251 251 251 251 251
251 251 251 162 162 162 162 162 162 162 251 251 251 251 251 251
251 251 251 162 162 162 162 162 162 162 251 251 251 251 251 251
251 251 251 162 162 162 162 162 162 162 251 251 251 251 251 251
251 251 251 162 162 162 162 162 162 162 251 251 251 251 251 251
251 251 251 162 162 162 162 162 162 162 251 251 251 251 251 251
251 251 251 044 044 044 044 044 044 044 251 251 251 251 251 251
254 251 003 044 044 044 044 044 044 044 005 251 251 251 251 251
254 251 022 044 044 044 044 044 044 044 020 251 251 251 251 251