254 251 044 044 044 044 044 044 044 044 044 251 251 251 251 251
254 251 044 044 044 044 044 044 044 044 044 251 251 251 251 251
254 251 044 044 044 044 044 044 044 044 044 251 251 251 251 251
254 251 044 044 044 044 044 044 044 044 044 251 251 251 251 251
254 251 044 044 044 044 044 044 044 044 044 251 251 251 251 251
251 251 044 044 044 044 044 044 044 044 044 251 251 251 251 251
251 251 044 044 044 044 044 044 044 044 044 251 251 251 251 251
251 251 044 044 044 044 044 044 044 044 044 251 251 251 251 251
251 251 044 044 044 044 044 044 044 044 044 251 251 251 251 251
161 161 044 044 044 044 044 044 044 044 044 251 251 251 251 251
161 161 044 044 044 044 044 044 044 044 044 251 251 251 251 251