161 161 044 044 044 044 044 044 044 044 044 251 251 251 251 251
161 161 044 044 044 044 044 044 044 044 044 251 251 251 251 251
161 161 044 044 044 044 044 044 044 044 044 251 251 251 251 251
161 161 044 044 044 044 044 044 044 044 044 251 251 251 251 251
161 161 044 044 044 044 044 044 044 044 044 251 251 251 251 251
161 161 044 044 044 044 044 044 044 044 044 251 251 251 251 251
161 161 044 044 044 044 044 044 044 044 044 251 251 251 251 251
161 161 044 044 044 044 044 044 044 044 044 251 251 251 251 251
161 033 044 044 044 044 044 044 044 044 044 251 251 251 251 251
044 044 044 044 044 044 044 044 044 044 044 251 251 251 164 164
044 044 044 044 044 044 044 044 044 044 044 251 251 251 164 164