044 044 044 044 044 044 044 044 044 044 044 251 251 251 164 164
044 044 044 044 044 044 044 044 044 044 044 251 251 251 164 164
044 044 044 044 044 044 044 044 044 044 030 161 161 161 164 164
044 044 044 044 044 044 044 044 044 044 055 161 161 161 164 164
044 044 044 044 044 044 044 044 030 161 161 161 161 161 164 164
044 044 044 044 044 055 161 161 161 161 161 161 161 161 164 164
044 044 044 055 161 161 161 161 161 161 161 161 161 161 164 164
044 044 055 161 161 161 161 161 161 161 161 161 161 161 164 164
161 161 161 161 161 161 161 161 161 161 161 161 161 161 164 164
164 164 161 161 161 161 161 161 161 161 161 161 161 161 164 164
164 164 161 161 161 161 161 161 161 161 161 161 161 161 164 164