164 164 161 161 161 161 161 161 161 161 161 161 161 161 164 164
164 164 161 161 161 161 161 161 161 161 161 161 161 161 164 164
161 161 161 161 161 161 161 161 161 161 161 161 161 161 161 161
161 161 161 161 161 161 161 161 161 161 161 161 161 161 161 161
161 161 161 161 161 161 161 161 161 161 161 161 161 161 161 161
161 161 161 161 161 161 161 161 161 161 161 161 161 161 161 161
161 161 161 161 161 161 161 161 161 161 161 161 161 161 161 161
164 164 170 161 161 161 161 161 161 161 161 161 161 161 161 161
164 164 164 164 164 164 164 170 161 161 161 161 161 172 164 164
164 164 164 164 164 164 164 164 161 161 161 161 161 164 164 164
164 164 164 164 164 164 164 164 161 161 161 161 161 164 164 164