251 251 251 251 251 251 251 251 251 251 251 251 251 251 254 254
251 251 251 251 251 251 251 251 251 251 251 251 251 251 242 254
251 251 251 251 251 251 251 251 251 251 251 251 251 251 251 254
251 251 251 251 251 251 022 044 044 044 044 044 044 044 044 044
044 044 044 044 044 044 044 044 044 044 044 044 044 044 044 044
044 044 044 044 044 044 044 044 044 044 044 044 044 044 044 044
044 044 044 044 044 044 044 044 044 044 044 044 044 044 044 044
044 044 044 044 044 044 044 044 044 044 044 044 044 044 044 044
044 044 044 044 044 044 044 044 044 044 044 044 044 044 044 044
251 251 251 251 251 251 251 251 251 251 251 251 251 251 251 251
251 251 251 251 251 251 251 251 251 251 251 251 251 251 251 251