251 251 251 251 251 251 251 251 251 251 251 251 044 044 251 251
251 251 251 251 251 251 251 251 251 251 251 251 044 044 251 251
251 251 251 251 251 251 251 251 251 251 251 251 251 251 251 251
251 251 251 251 251 251 251 251 251 251 251 251 251 251 251 251
251 251 251 251 251 251 251 251 251 251 251 251 044 044 044 044
251 251 251 251 251 251 251 251 251 251 251 251 044 044 044 044
251 251 251 251 251 251 251 251 251 251 251 251 251 251 251 251
251 251 251 251 251 251 251 251 251 251 251 251 251 251 251 251
251 251 251 251 251 251 251 251 251 251 251 251 251 251 251 251
164 164 164 164 164 164 164 164 164 164 164 164 164 164 164 164
164 164 164 164 164 164 164 164 164 164 164 164 164 164 164 164