164 164 164 161 161 161 161 161 161 161 161 161 161 164 164 164
164 164 164 161 161 161 161 164 164 161 161 161 161 152 164 164
164 164 150 161 161 161 161 152 150 161 161 161 161 164 164 164
161 161 161 161 161 161 161 161 164 164 164 164 164 164 164 164
161 161 161 161 161 161 161 161 164 164 172 164 164 164 164 164
161 161 161 161 161 161 164 164 164 164 164 164 164 164 164 164
161 161 161 161 161 161 164 164 164 164 164 164 164 164 164 164
161 161 161 161 161 161 164 164 164 164 164 164 164 164 164 164
164 164 164 164 164 164 164 164 164 164 164 164 164 164 164 164
164 164 164 164 164 164 164 164 164 164 164 164 164 164 164 164
164 164 164 164 164 164 164 164 164 164 164 164 164 164 164 164