254 254 254 254 254 254 254 254 254 254 254 254 254 254 254 254
254 254 254 254 254 254 254 254 254 254 254 254 254 254 254 254
254 254 251 251 251 251 251 251 251 251 251 251 251 251 251 251
254 254 251 251 251 251 251 251 251 251 251 251 251 284 251 251
254 251 251 251 251 251 251 251 251 251 251 251 251 251 251 251
251 251 251 251 251 251 251 251 251 251 251 251 251 251 284 251
251 251 251 251 251 251 251 251 251 251 251 251 251 251 251 251
254 251 251 251 251 251 251 251 251 251 284 251 251 251 251 251
254 260 251 251 251 251 251 251 251 251 251 251 251 284 251 251
254 254 260 251 251 251 251 251 251 251 251 251 251 251 251 251
254 254 254 251 251 251 251 251 251 251 251 251 251 251 251 251