044 044 044 044 044 044 044 044 044 044 044 044 044 044 044 044
044 044 044 044 044 044 044 044 044 044 044 044 044 044 044 044
044 044 251 251 251 251 251 251 251 251 251 251 251 251 044 044
044 044 251 251 251 251 251 251 251 221 221 221 221 221 044 044
044 044 251 251 251 251 251 251 251 221 221 221 221 221 044 044
044 044 251 251 221 221 221 221 221 221 221 221 221 221 044 044
044 044 251 251 221 221 221 221 221 221 221 221 221 221 044 044
044 044 251 251 221 221 221 221 044 044 044 044 044 044 044 044
044 044 251 251 221 221 221 221 044 044 044 044 044 044 044 044
251 251 251 251 221 221 044 044 044 044 044 044 044 044 044 044
251 251 251 251 221 221 044 044 044 044 044 044 044 044 044 044