251 251 221 221 221 221 044 044 044 044 044 044 044 044 044 044
251 251 221 221 221 221 044 044 044 044 044 044 044 044 044 044
221 221 221 221 221 221 044 044 044 044 044 044 044 044 044 044
221 221 221 221 221 221 044 044 044 044 044 044 044 044 044 044
044 044 044 044 044 044 044 044 044 044 044 044 044 044 044 044
044 044 044 044 044 044 044 044 044 044 044 044 044 044 044 044
251 251 251 251 251 251 251 251 251 251 251 251 251 251 251 251
251 251 251 251 251 251 251 251 251 251 251 251 251 251 251 251
251 251 251 251 251 251 251 251 251 251 251 251 251 251 251 251
164 164 251 251 251 251 251 251 251 251 251 251 251 251 251 251
164 164 251 251 251 251 251 251 251 251 251 251 251 251 251 251