164 164 251 251 251 251 251 251 251 251 251 251 251 251 251 251
164 164 251 251 251 251 251 251 251 251 251 251 251 251 251 251
161 161 161 161 161 161 161 161 161 251 251 251 251 251 251 251
161 161 161 161 161 161 161 161 161 161 251 251 251 251 251 251
161 161 161 161 161 161 161 161 161 161 161 251 251 251 251 251
161 161 161 161 161 161 161 161 161 161 161 161 251 251 251 251
161 161 161 161 161 161 161 161 161 161 161 161 161 251 251 251
164 170 161 161 161 161 161 161 161 161 161 161 161 161 251 251
164 164 161 161 161 161 161 161 161 161 161 161 161 161 251 251
164 164 161 161 161 161 161 161 161 161 161 161 161 161 164 164
164 164 161 161 161 161 161 161 161 161 161 161 161 161 164 164