044 044 251 251 251 251 251 251 251 251 251 251 251 251 251 251
044 044 251 251 251 251 251 251 251 251 251 251 251 251 251 251
044 044 251 251 251 251 251 251 251 251 251 251 251 251 251 251
044 044 251 251 251 251 251 251 251 251 251 251 251 251 251 251
044 044 251 251 251 251 251 251 251 251 251 251 251 251 251 251
044 044 251 251 251 251 251 251 251 251 251 251 251 251 251 251
044 044 251 251 251 251 251 251 251 251 251 251 251 251 251 251
044 044 251 251 251 251 251 251 251 251 251 251 251 251 251 251
044 044 251 251 251 251 251 251 251 251 251 251 251 251 251 251
044 044 251 251 251 251 251 251 251 251 251 251 251 251 262 254
044 044 251 251 251 251 251 251 251 251 251 251 251 251 254 254