164 164 164 164 164 164 164 164 164 164 164 164 164 191 191 164
164 164 164 164 164 164 164 164 164 164 164 164 180 191 191 164
164 164 191 191 191 191 191 191 191 191 191 191 191 191 191 164
164 164 191 191 191 191 191 191 191 191 191 191 191 191 191 164
164 164 191 191 191 191 191 191 191 191 191 191 191 191 191 164
164 164 191 191 191 191 191 191 191 191 191 191 191 191 191 164
164 164 191 191 191 191 191 191 191 191 191 191 191 191 191 182
164 164 191 191 191 191 191 191 191 191 191 191 191 191 191 191
164 164 191 191 191 191 191 191 191 191 191 191 191 191 191 191
164 164 191 191 191 191 191 191 191 191 191 191 191 191 191 202
164 164 191 191 191 191 191 191 191 191 191 191 191 191 191 164