164 164 161 161 161 161 161 161 161 161 200 191 191 191 191 164
164 150 161 161 161 161 161 161 161 161 161 191 191 191 191 164
161 161 161 161 161 161 161 161 161 161 161 200 191 191 202 164
161 161 161 161 161 161 161 161 161 161 161 161 161 161 164 164
164 170 161 161 161 161 161 161 161 161 161 161 161 161 164 164
164 164 284 284 284 284 284 284 284 284 284 284 284 284 164 164
164 164 284 284 284 284 284 284 284 284 284 284 284 284 164 164
164 164 284 284 284 284 284 284 284 284 284 284 284 284 164 164
164 164 284 284 284 284 284 284 284 284 284 284 284 284 164 164
164 164 284 284 284 284 284 284 284 284 284 284 284 284 164 164
164 164 284 284 284 284 284 284 284 284 284 284 284 284 164 164