251 251 044 044 044 044 044 044 044 044 044 044 044 044 044 284
251 003 044 044 044 044 044 044 044 044 044 044 044 044 044 284
003 044 044 044 044 044 044 044 044 044 044 044 044 044 044 284
044 044 044 044 044 044 044 044 044 044 044 044 044 044 044 284
044 044 044 044 044 044 044 044 044 044 044 044 044 044 044 284
044 044 044 044 044 044 044 044 044 044 044 044 044 044 044 284
044 044 044 044 044 044 044 044 044 044 044 044 044 044 044 284
044 044 044 044 044 044 044 044 044 044 044 044 044 044 044 284
044 044 044 044 044 044 044 044 044 044 044 044 044 044 044 284
251 023 044 044 044 044 044 044 044 044 044 044 044 044 044 284
251 251 044 044 044 044 044 044 044 044 044 044 044 044 044 284