251 251 044 044 044 044 044 044 044 044 044 044 044 044 044 284
251 251 044 044 044 044 044 044 044 044 044 044 044 044 044 044
251 251 044 044 044 044 044 044 044 044 044 044 044 044 044 044
251 251 044 044 044 044 044 044 044 044 044 044 044 044 044 044
251 251 044 044 044 044 044 044 044 044 044 044 044 044 044 044
251 251 023 044 044 044 044 044 044 044 044 044 044 044 044 044
251 251 251 023 044 044 044 044 044 044 044 044 044 044 044 044
251 251 251 251 023 044 044 044 044 044 044 044 044 044 044 044
251 251 251 251 251 251 251 251 251 251 251 251 251 251 251 251
251 251 251 256 258 251 251 251 251 251 251 251 251 251 251 251
251 251 251 267 267 251 251 251 251 251 251 251 251 251 251 251