251 251 251 267 267 251 251 251 251 251 251 251 251 251 251 251
251 131 131 267 267 131 131 131 131 131 131 131 131 131 131 251
251 131 131 267 267 131 131 131 131 131 131 131 131 131 131 251
251 131 131 267 267 131 131 131 267 267 267 267 131 131 131 251
251 131 131 267 267 267 267 267 267 267 267 267 267 267 267 267
251 251 251 228 267 267 267 267 267 267 267 267 267 267 267 267
251 008 009 251 131 131 131 131 131 131 131 131 131 131 131 251
251 018 019 251 131 131 131 131 131 131 131 131 131 131 131 251
251 251 251 251 251 251 251 251 251 251 251 251 251 251 251 251
254 254 254 254 254 254 254 254 254 254 254 254 254 254 254 254
254 254 254 254 254 254 254 254 254 254 254 254 254 254 254 254