254 254 254 254 254 254 254 254 254 254 254 254 254 254 254 254
254 254 254 254 254 254 254 254 254 254 254 254 254 254 254 254
251 251 251 251 251 251 251 251 251 251 251 251 251 251 251 251
251 191 191 191 191 191 191 191 191 191 191 191 191 191 191 251
251 251 251 251 251 251 251 251 251 251 251 251 251 251 251 251
251 191 191 191 191 191 191 191 191 191 191 191 191 191 191 251
251 251 251 251 251 251 251 251 251 251 251 251 251 251 251 251
251 191 191 191 191 191 191 191 191 191 191 191 191 191 191 251
251 251 251 251 251 251 251 251 251 251 251 251 251 251 251 251
251 191 191 191 191 191 191 191 191 191 191 191 191 191 191 251
251 251 251 251 251 251 251 251 251 251 251 251 251 251 251 251