251 251 251 251 251 251 251 251 251 251 251 251 251 251 251 251
251 251 251 251 251 251 251 251 251 251 251 251 251 251 251 251
251 251 251 251 251 251 251 251 251 251 248 267 267 246 251 251
251 251 251 251 251 251 251 251 251 251 267 267 267 267 251 251
251 251 248 267 267 246 251 251 251 251 267 267 267 267 251 251
251 251 267 267 267 267 251 251 251 251 251 251 251 251 251 251
251 251 267 267 267 267 251 251 251 251 251 251 251 251 251 251
251 251 251 251 251 251 251 251 251 251 251 251 251 251 251 251
251 251 251 251 251 251 251 251 251 251 251 251 251 251 251 251
164 164 164 164 164 164 164 164 164 164 164 164 164 164 164 164
164 164 164 164 164 164 164 164 164 164 164 164 164 164 164 164