191 191 191 191 191 191 191 191 191 191 191 191 191 191 191 191
191 191 191 191 191 191 191 191 191 191 191 191 191 191 191 191
191 191 191 191 191 191 191 191 191 191 191 191 128 129 191 191
191 191 191 191 191 191 191 191 191 191 191 191 138 139 191 191
191 191 191 191 191 191 191 191 191 191 191 191 191 191 191 191
191 191 191 191 191 191 191 191 191 191 191 191 183 185 191 191
191 191 191 191 191 191 191 191 191 191 191 191 193 195 191 191
191 191 191 191 191 191 191 191 191 191 191 191 193 195 191 191
191 191 191 191 191 191 191 191 191 191 191 191 203 205 191 191
191 191 191 191 191 191 191 191 191 191 191 191 191 191 191 191
191 191 191 191 191 191 191 191 191 191 191 191 191 191 191 191