284 161 161 131 131 131 131 131 131 131 131 267 267 267 267 267
284 161 161 131 131 131 131 131 131 131 131 267 267 267 267 267
284 161 161 131 131 131 131 131 131 131 131 267 267 267 267 267
284 161 161 131 131 131 131 131 131 131 131 267 267 267 267 267
284 161 161 267 267 267 267 267 267 267 267 267 267 267 267 267
284 161 161 267 267 267 267 267 267 267 267 267 267 267 267 267
284 161 161 267 267 267 267 267 163 163 163 163 163 163 163 163
284 161 161 267 267 267 267 267 163 163 163 163 163 163 163 163
284 161 161 161 161 161 161 161 161 161 161 161 161 161 161 161
284 161 161 161 161 161 161 161 161 161 161 161 161 161 161 161
284 284 284 284 284 284 284 284 284 284 284 284 284 284 284 284