251 251 251 251 251 251 251 251 251 251 251 251 251 251 251 251
251 251 251 131 131 131 131 131 131 131 131 131 131 251 251 251
251 251 251 131 131 131 131 131 131 131 131 131 131 251 251 251
251 251 251 251 251 251 131 131 131 131 251 251 251 251 251 251
267 267 267 267 251 251 131 131 131 131 251 248 267 267 267 267
267 267 267 267 251 251 251 267 267 251 251 267 267 267 267 267
251 276 267 267 258 251 251 267 267 251 256 267 267 267 267 267
251 251 267 267 267 267 267 267 267 267 267 267 267 267 267 267
251 251 267 267 267 267 267 267 267 267 267 267 267 267 267 267
254 260 267 267 262 254 254 254 254 254 254 254 254 254 254 254
254 254 267 267 254 254 254 254 254 254 254 254 254 254 254 254