254 254 267 267 254 254 254 254 254 254 254 254 254 254 254 254
254 254 267 267 254 254 254 254 254 254 254 254 254 254 254 254
251 251 267 267 251 251 251 251 251 251 251 251 251 251 251 251
191 191 267 267 191 191 191 191 191 191 191 191 191 251 254 254
251 251 267 267 251 251 251 251 251 251 251 251 251 251 254 254
191 191 267 267 191 191 191 191 191 191 191 191 191 251 254 254
251 251 267 267 251 251 251 251 251 251 251 251 251 251 254 254
191 191 267 267 191 191 191 191 191 191 191 191 191 251 254 254
251 251 267 267 251 251 251 251 251 251 251 251 251 251 254 254
191 191 228 226 191 191 191 191 191 191 191 191 191 251 254 254
251 251 251 251 251 251 251 251 251 251 251 251 251 251 254 254