251 251 251 251 251 251 251 251 251 251 251 251 251 251 254 254
251 191 191 191 191 191 191 191 191 191 191 191 191 251 254 254
251 191 191 191 191 191 191 191 191 191 191 191 191 251 254 254
251 191 191 191 191 191 191 191 191 191 191 191 191 251 242 254
251 191 191 191 191 191 191 191 191 191 191 191 191 251 251 251
251 191 191 191 191 191 191 191 191 191 191 191 191 251 251 251
251 191 191 191 191 191 191 191 191 191 191 191 191 251 251 251
251 191 191 191 191 191 191 191 191 191 191 191 191 251 251 251
251 251 251 251 251 251 251 251 251 251 251 251 251 251 251 251
164 164 164 164 164 164 164 164 164 164 164 164 164 164 164 164
164 164 164 164 164 164 164 164 164 164 164 164 164 164 164 164