191 191 191 191 191 191 191 191 191 191 191 191 191 191 191 191
191 191 191 191 191 191 191 191 191 191 191 191 191 191 191 191
191 191 191 191 191 191 191 191 191 191 191 191 191 191 191 191
191 191 191 191 191 191 191 191 191 191 191 191 191 191 191 191
191 191 191 191 191 191 191 191 191 191 191 191 191 191 191 191
191 191 191 191 191 048 064 064 064 064 049 191 191 191 191 191
191 191 191 191 191 073 074 074 074 074 075 191 191 191 191 191
191 191 191 191 191 049 084 084 084 084 059 191 191 191 191 191
191 191 191 191 191 191 191 191 191 191 191 191 191 191 191 191
191 191 191 191 191 191 191 191 191 191 191 191 191 191 191 191
191 191 191 191 191 191 191 191 191 191 191 191 191 191 191 191