251 251 251 251 251 251 251 251 251 251 251 251 251 251 251 251
251 131 131 131 131 131 131 251 251 251 248 131 131 246 251 251
251 131 131 131 131 131 131 251 251 248 131 131 131 131 246 251
251 251 251 251 251 131 131 251 251 131 131 131 131 131 131 251
267 267 267 267 251 131 131 251 251 131 131 131 131 131 131 251
267 267 267 267 251 131 131 251 251 228 131 131 131 131 226 251
267 267 267 267 251 131 131 251 251 251 228 131 131 226 251 251
267 267 267 267 267 267 267 267 267 267 267 267 267 267 267 267
267 267 267 267 267 267 267 267 267 267 267 267 267 267 267 267
254 260 251 254 251 254 251 254 267 267 254 251 254 251 254 251
254 254 251 251 251 251 251 251 267 267 251 251 251 251 251 251