254 254 251 251 251 251 251 251 267 267 251 251 251 251 251 251
254 254 251 251 251 251 251 251 267 267 251 251 251 251 251 251
254 254 251 251 251 251 123 124 124 124 124 125 251 251 251 251
254 254 251 251 251 123 123 124 124 124 124 125 125 251 251 251
254 254 251 251 251 133 133 123 124 124 125 135 135 251 251 251
254 254 251 251 251 133 133 133 123 125 135 135 135 251 251 251
254 254 251 251 251 133 133 133 143 145 135 135 135 251 251 251
254 254 251 251 251 133 133 143 144 144 145 135 135 251 251 251
254 254 251 251 251 143 143 144 144 144 144 145 145 251 251 251
254 254 251 251 251 251 143 144 144 144 144 145 251 251 251 251
254 254 251 251 251 251 251 251 251 251 251 251 251 251 251 251