254 254 251 251 251 251 251 251 251 251 251 251 251 251 251 251
254 254 251 251 251 251 251 251 251 251 251 251 251 251 251 251
254 254 251 251 251 251 251 251 251 251 251 251 251 251 251 251
254 240 251 251 267 267 267 267 246 251 251 251 251 251 251 251
251 251 251 248 267 267 267 267 267 267 246 258 251 267 251 251
251 251 251 267 267 267 267 267 267 267 267 267 267 267 251 251
251 251 251 267 267 267 267 267 267 226 226 251 251 267 251 251
251 251 251 251 251 251 251 251 251 251 251 251 251 251 251 251
251 251 251 251 251 251 251 251 251 251 251 251 251 251 251 251
164 164 164 164 164 164 164 164 164 164 164 164 164 164 164 164
164 164 164 164 164 164 164 164 164 164 164 164 164 164 164 164