22 22 22 23 3  3  3  0  1  2  3  4  5  6  7 	 
38 38 38 31 3  3  3  8  9  10 11 12 13 14 15 	 
38 38 38 39 3  3  3  16 17 18 19 20 21 22 23	 
38 38 12 12 3  3  3  24 25 26 27 28 29 30 31 	 
38 38 38 39 3  3  3  32 33 34 35 36 37 38 39	 
38 38 38 39 3  3  3  40 41 42 43 44 45 46 47	 
38 38 38 39 3  3  3  48 49 50 51 52 53 54 55 	 
38 38 38 39 3  3  3  56 57 58 59 60 61 62 63