14 14 14 15 2  2  2  0  1  2  3  4  5  6  7 	 
22 22 22 23 2  2  2  8  9  10 11 12 13 14 15 	 
30 30 30 31 2  8  2  16 17 18 19 20 21 22 23	 
30 30 12 12 2  2  2  24 25 26 27 28 29 30 31 	 
30 30 30 31 2  8  2  32 33 34 35 36 37 38 39	 
30 30 30 31 2  2  2  40 41 42 43 44 45 46 47	 
30 30 30 31 2  8  2  48 49 50 51 52 53 54 55 	 
30 30 30 31 2  2  2  56 57 58 59 60 61 62 63