284 284 284 284 284 284 284 284 284 284 284 284 284 284 284 284
044 044 044 044 151 151 151 151 151 151 151 151 044 044 044 044
044 044 044 044 151 151 151 151 151 151 151 151 044 044 044 044
044 044 044 044 151 151 151 151 151 151 151 151 044 044 044 044
044 044 044 044 151 151 151 151 151 151 151 151 044 044 044 044
044 044 044 044 151 151 151 151 151 151 151 151 044 044 044 044
044 044 044 044 151 151 151 151 151 151 151 151 044 044 044 044
044 044 044 044 151 151 151 151 151 151 151 151 044 044 044 044
251 251 251 251 251 251 251 251 251 251 251 251 251 251 251 251
251 251 251 251 251 251 251 251 251 251 251 251 251 251 251 251
251 251 251 251 251 248 267 267 267 267 246 251 251 251 251 251