251 251 251 251 251 267 267 267 267 267 267 251 251 251 251 251
251 168 169 251 251 267 267 267 267 267 267 251 251 168 169 251
251 178 179 251 251 267 267 267 267 267 267 251 251 178 179 251
251 251 251 251 251 267 267 267 267 267 267 251 251 251 251 251
251 168 169 251 251 267 267 267 267 267 267 251 251 168 169 251
251 178 179 251 251 267 267 267 267 267 267 251 251 178 179 251
251 251 251 251 251 267 267 267 267 267 267 251 251 251 251 251
267 267 267 267 267 267 267 267 267 267 267 251 251 251 251 251
267 267 267 267 267 267 267 267 267 267 267 251 251 168 169 251
251 251 251 251 251 267 267 267 267 267 267 251 251 178 179 251
251 251 251 251 251 267 267 267 267 267 267 267 267 267 267 267