251 251 251 251 251 267 267 267 267 267 267 267 267 267 267 267
251 131 131 251 251 267 267 267 267 267 267 251 251 131 131 251
251 131 131 267 267 267 267 267 267 267 267 267 267 131 131 251
251 131 131 251 251 267 267 267 267 267 267 251 251 131 131 251
251 131 131 251 251 267 267 267 267 267 267 251 251 131 131 251
251 251 251 251 251 267 267 267 267 267 267 251 251 251 251 251
251 131 131 251 251 267 267 267 267 267 267 251 251 131 131 251
251 131 131 267 267 267 267 267 267 267 267 267 267 131 131 251
251 131 131 251 251 267 267 267 267 267 267 251 251 131 131 251
251 131 131 251 251 228 267 267 267 267 226 251 251 131 131 251
251 251 251 251 251 251 251 251 251 251 251 251 251 251 251 251