251 251 251 251 251 251 251 251 251 251 251 251 251 251 251 251
251 168 169 251 251 168 169 251 251 168 169 251 251 168 169 251
251 178 179 251 251 178 179 251 251 178 179 251 251 178 179 251
251 251 251 251 251 251 251 251 251 251 251 251 251 251 251 251
251 168 169 251 251 168 169 251 022 044 044 044 044 044 044 044
251 178 179 251 251 178 179 251 044 044 044 044 044 044 044 044
251 251 251 251 251 251 251 251 044 044 044 044 044 044 044 044
251 251 251 251 251 251 251 235 044 044 044 044 044 044 044 044
251 251 251 251 235 191 191 191 044 044 044 044 044 044 044 044
164 251 251 235 191 191 191 191 044 044 044 044 044 044 044 044
164 191 191 191 191 191 191 191 044 044 044 044 044 044 044 044