254 191 191 191 191 191 191 191 044 044 044 044 044 044 044 044
254 191 191 191 191 191 191 191 044 044 044 044 044 044 044 044
254 191 191 191 191 191 191 191 044 044 044 044 044 044 044 044
254 191 191 191 191 191 191 191 044 044 044 044 044 044 044 025
254 191 191 191 191 191 191 191 044 044 044 044 044 044 025 251
254 191 191 191 191 191 191 191 044 044 044 044 044 025 251 251
254 191 191 191 191 191 191 191 044 044 044 044 044 251 251 251
254 191 191 191 191 191 191 191 044 044 044 044 044 251 251 251
254 191 191 191 191 191 191 191 044 044 044 044 044 251 251 251
254 191 191 191 191 191 191 191 044 044 044 044 044 251 251 254
254 191 191 191 191 191 191 191 044 044 044 044 044 251 251 254