254 191 191 191 191 191 191 191 044 044 044 044 044 251 251 254
254 191 191 191 191 191 191 191 044 044 044 044 044 251 251 254
254 191 191 191 191 191 191 191 044 044 044 044 044 251 251 254
254 191 191 191 191 191 191 191 044 044 044 044 044 005 251 254
254 191 191 191 191 191 191 191 044 044 044 044 044 020 251 254
254 191 191 191 191 191 191 191 044 044 044 044 044 044 005 254
254 191 191 191 191 191 191 191 044 044 044 044 044 044 044 095
254 191 191 191 191 191 191 191 044 044 044 044 044 044 044 044
254 191 191 191 191 191 191 191 044 044 044 044 044 044 044 044
254 191 191 191 191 191 191 191 044 044 044 044 044 044 044 044
254 191 191 191 191 191 191 191 044 044 044 044 044 044 044 044