284 284 284 284 284 284 284 284 284 284 284 284 284 284 284 284
044 044 044 044 044 044 044 044 044 044 044 044 044 044 044 044
044 044 044 044 044 044 044 044 044 044 044 044 044 044 044 044
044 044 044 044 044 044 044 044 044 044 044 044 044 044 044 044
044 044 044 044 044 044 044 044 044 044 044 044 044 044 044 044
044 044 044 044 044 044 044 044 044 044 044 044 044 044 044 044
044 044 044 044 044 044 044 044 044 044 044 044 044 044 044 044
044 044 044 044 044 044 044 044 044 044 044 044 044 044 044 044
251 251 251 023 044 044 044 044 044 044 044 044 044 044 044 044
251 251 251 251 044 044 044 044 044 044 044 044 044 044 044 044
251 251 251 251 044 044 044 044 044 044 044 044 044 044 044 044