251 251 251 251 044 044 044 044 044 044 055 165 165 161 161 161
251 131 131 251 044 044 044 044 044 055 162 165 165 161 161 161
251 131 131 251 044 044 044 044 055 161 162 161 161 161 161 161
251 131 131 251 044 044 044 055 161 161 162 161 161 161 161 161
251 131 131 251 044 044 044 161 161 161 162 161 161 161 161 161
251 267 267 251 044 044 044 161 161 161 162 161 161 161 161 161
251 267 267 251 044 044 044 161 161 161 162 161 161 161 161 161
251 267 267 251 044 044 044 161 161 161 162 161 161 161 161 161
251 267 267 251 044 044 044 161 161 161 162 161 161 161 161 161
251 267 267 251 044 044 044 161 161 161 162 161 161 161 161 161
267 267 267 251 044 044 044 035 161 161 162 161 161 161 161 161