267 267 267 251 044 044 044 044 161 161 162 161 161 161 161 161
251 267 267 251 044 044 044 044 044 035 162 165 165 161 161 161
251 267 267 251 044 044 044 044 044 044 035 165 165 161 161 161
251 267 267 251 044 044 044 044 044 044 044 044 044 044 044 044
251 267 267 251 044 044 044 044 044 044 044 044 044 044 044 044
251 267 267 251 044 044 044 044 044 044 044 044 044 044 044 044
251 267 267 251 044 044 044 044 044 044 044 044 044 044 044 044
251 267 267 267 162 162 162 162 162 162 162 162 162 162 162 162
251 267 267 267 162 162 162 162 162 162 162 162 162 162 162 162
251 251 251 251 044 044 044 044 044 044 044 044 044 044 044 044
251 251 251 251 044 044 044 044 044 044 044 044 044 044 044 044