251 251 251 251 044 044 044 044 044 044 044 044 044 044 044 044
251 168 169 251 044 044 044 044 044 044 044 044 044 044 044 044
251 178 179 251 044 044 044 044 044 044 044 044 044 044 044 044
251 251 251 003 044 044 044 044 044 044 044 044 044 044 044 044
044 044 044 044 044 044 044 044 044 044 044 044 044 044 044 044
044 044 044 044 044 044 044 044 044 044 044 044 044 044 044 044
044 044 044 044 044 044 044 044 044 044 044 044 044 044 044 044
044 044 044 044 044 044 044 044 044 044 044 044 025 251 251 251
044 044 044 044 044 044 044 044 025 251 251 251 251 251 251 251
044 044 044 044 025 251 251 251 251 251 251 251 251 251 254 254
044 044 044 025 251 251 251 251 251 251 251 251 251 251 254 254