044 044 025 251 251 251 251 251 251 251 251 251 251 251 254 254
044 025 251 251 251 251 251 251 251 251 251 251 251 251 254 254
025 251 251 248 247 246 251 251 251 251 251 251 251 251 251 251
251 251 251 267 267 267 251 251 251 251 251 251 251 251 251 251
251 251 251 251 251 251 251 251 251 251 251 251 251 251 251 251
251 251 251 251 251 251 251 251 251 248 247 246 251 251 251 251
251 251 251 251 251 251 251 251 251 267 267 267 251 251 251 251
251 251 248 247 246 251 251 251 251 251 251 251 251 251 251 251
251 251 267 267 267 251 251 251 251 251 251 251 251 251 251 251
254 251 251 251 251 251 251 251 251 251 251 251 251 262 254 254
254 251 251 251 251 251 251 251 251 251 251 254 254 254 254 254