254 251 251 251 251 251 251 251 251 251 251 254 254 254 254 254
254 251 251 251 251 251 251 251 251 251 251 254 254 254 254 254
254 251 251 251 251 251 251 251 251 251 251 254 254 254 254 254
254 251 251 251 251 251 251 251 251 251 251 254 254 254 254 254
254 251 251 251 251 251 251 251 251 251 251 254 254 254 254 254
254 251 251 251 251 251 251 251 251 251 251 254 254 254 254 093
254 251 251 251 251 251 251 251 251 251 251 254 093 044 044 044
095 251 251 251 251 251 251 251 251 251 251 003 044 044 044 044
044 005 251 251 251 251 251 251 251 251 003 044 044 044 044 044
044 044 044 044 044 044 044 044 044 044 044 044 044 044 044 044
044 044 044 044 044 044 044 044 044 044 044 044 044 044 044 044