267 267 267 267 267 267 267 267 267 267 267 267 267 267 267 267
267 267 267 267 267 267 267 267 267 267 267 267 267 267 267 267
267 267 267 267 267 267 267 267 267 267 267 267 267 267 267 267
267 267 131 131 131 131 131 131 131 131 131 131 131 131 267 267
267 267 131 131 131 131 131 131 131 131 131 131 131 131 267 267
267 267 131 131 131 131 131 131 131 131 131 131 131 131 267 267
267 267 131 131 131 131 131 131 131 131 131 131 131 131 267 267
267 267 131 131 131 131 131 131 131 131 131 131 131 131 267 267
161 161 161 161 161 161 161 161 161 161 161 161 161 161 161 161
161 161 161 161 161 161 161 161 161 161 161 161 161 161 161 161
284 284 284 284 284 284 284 284 284 284 284 284 284 284 284 284