161 161 161 161 161 161 161 161 161 161 161 161 161 161 161 053
161 161 161 161 161 161 161 161 161 161 161 161 161 161 161 161
161 161 161 161 161 161 161 161 161 161 161 161 161 161 161 161
161 161 161 161 161 163 163 163 163 163 163 161 161 161 161 161
161 161 161 161 161 163 163 163 163 163 163 161 161 161 161 161
161 161 161 161 161 163 163 163 163 163 163 161 161 161 161 161
161 161 108 109 161 163 163 163 163 163 163 161 108 109 161 161
161 161 118 119 161 163 163 163 163 163 163 161 118 119 161 161
161 161 161 161 161 163 163 163 163 163 163 161 161 161 161 161
161 161 161 161 161 163 163 163 163 163 163 161 161 161 161 161
161 161 161 161 161 163 163 163 163 163 163 161 161 161 161 161