161 161 161 161 161 161 161 161 161 161 161 161 161 161 161 161
161 161 161 161 161 161 161 161 161 161 161 161 161 161 161 161
161 161 161 161 161 161 161 174 174 161 161 161 161 161 161 033
044 044 044 044 044 044 044 174 174 044 044 044 044 044 044 044
044 044 044 044 044 044 044 174 174 044 044 044 044 044 044 044
044 044 044 044 044 044 044 174 174 044 044 044 044 044 044 044
044 044 044 044 044 044 044 174 174 044 044 044 044 044 044 044
162 162 162 162 162 162 162 162 162 162 162 162 162 162 162 162
162 162 162 162 162 162 162 162 162 162 162 162 162 162 162 162
044 044 044 044 044 044 044 044 044 044 044 044 044 044 044 044
044 044 044 044 044 044 044 044 044 044 044 044 044 044 044 044