254 254 251 251 251 251 251 251 251 251 251 251 251 191 191 191
254 254 251 251 251 251 251 251 251 251 251 251 251 191 191 191
251 251 251 251 251 251 251 251 251 251 251 251 251 215 191 191
251 251 254 254 254 254 254 254 254 251 251 251 251 251 191 191
251 251 254 254 254 254 254 254 254 251 251 251 251 251 215 191
251 251 251 251 251 251 251 251 251 251 251 251 251 251 251 251
251 251 254 254 251 251 251 254 254 251 251 251 254 254 251 251
251 251 254 254 251 251 251 251 251 251 251 251 254 254 251 251
251 251 254 254 251 251 251 254 254 251 251 251 254 254 251 251
254 251 251 251 251 251 251 251 251 251 251 251 251 251 251 251
254 254 251 251 251 251 254 254 254 254 251 251 251 251 251 254