254 254 251 251 251 251 254 254 254 254 251 251 251 251 251 254
254 254 251 251 251 251 251 251 251 251 251 251 251 251 251 251
254 254 251 251 251 251 251 251 251 251 251 251 251 251 251 251
254 093 044 044 044 044 044 044 044 044 095 251 251 251 251 251
093 044 044 044 044 044 044 044 044 044 044 095 251 251 251 251
044 044 044 044 044 044 044 044 044 044 044 044 095 251 251 251
044 044 044 044 044 044 044 044 044 044 044 044 044 095 251 251
044 044 044 044 044 044 044 044 044 044 044 044 044 044 095 251
044 044 044 044 044 044 044 044 044 044 044 044 044 044 044 044
044 044 044 044 044 044 044 044 044 044 044 044 044 044 044 044
044 044 044 044 044 044 044 044 044 044 044 044 044 044 044 044