044 044 044 044 044 044 044 044 044 044 044 044 044 044 044 044
161 161 053 044 044 044 044 044 044 044 044 044 044 044 044 044
161 161 161 161 165 044 044 044 044 044 044 044 044 044 044 044
161 161 161 161 165 165 162 053 044 044 044 044 044 044 044 044
161 161 161 161 161 161 162 161 053 044 044 044 044 044 044 044
161 161 161 161 161 161 162 161 161 053 053 044 044 044 044 044
161 161 161 161 161 161 162 161 161 161 161 054 054 054 044 044
161 161 161 161 161 161 162 161 161 161 161 034 034 034 044 044
161 161 161 161 161 161 162 161 161 033 033 044 044 044 044 044
161 161 161 161 161 161 162 161 033 044 044 044 044 044 044 044
161 161 161 161 165 165 162 033 044 044 044 044 044 044 044 044