161 161 161 161 165 044 044 044 044 044 044 044 044 044 044 044
161 161 033 044 044 044 044 044 044 044 044 044 044 044 044 044
044 044 044 044 044 044 044 044 044 044 044 044 044 044 044 044
044 044 044 044 044 044 044 044 044 044 044 044 044 044 044 044
044 044 044 044 044 044 044 044 044 044 044 044 044 044 044 044
044 044 044 044 044 044 044 044 044 044 044 044 044 044 044 044
044 044 044 044 044 044 044 044 044 044 044 044 044 044 044 044
162 162 044 044 044 044 044 044 267 267 044 044 044 044 044 044
162 162 044 044 044 044 044 044 267 267 044 044 044 267 267 044
044 044 044 044 044 044 044 044 044 044 044 044 044 267 267 044
044 044 044 044 044 044 044 044 044 044 044 044 044 044 044 044