044 044 044 044 044 044 044 044 044 044 044 044 044 044 044 044
044 044 044 044 044 044 044 044 044 044 044 044 044 044 044 044
044 044 044 044 044 044 044 044 044 044 044 044 044 267 267 044
044 044 044 044 044 044 044 044 044 044 044 044 044 267 267 044
044 044 044 044 044 044 044 044 044 044 044 044 044 044 044 044
044 044 044 044 044 044 044 044 044 044 044 044 044 044 044 044
044 044 044 044 044 044 044 044 044 044 044 044 044 044 044 044
191 191 191 191 191 083 044 044 044 044 044 044 044 044 044 044
191 191 191 191 191 191 191 191 083 044 044 044 044 044 044 044
191 191 191 191 191 191 191 191 191 083 044 044 044 044 044 044
191 191 191 191 191 191 191 191 191 191 083 044 044 044 044 044