191 191 191 191 191 191 191 191 191 191 191 044 044 044 044 044
191 191 191 191 191 191 191 191 191 191 191 083 044 044 044 044
191 191 191 191 191 191 191 191 191 191 191 191 044 044 044 044
191 191 191 191 191 191 191 191 191 191 191 191 044 044 044 044
191 191 191 191 191 191 191 191 191 191 191 191 044 044 044 044
251 215 191 191 191 191 191 191 191 191 191 191 044 044 044 044
251 251 251 251 215 191 191 191 191 191 191 191 044 044 044 044
251 251 251 251 251 215 191 191 191 191 191 191 083 044 044 044
251 251 251 251 251 262 260 191 191 191 191 191 191 044 044 044
243 254 254 254 254 254 254 254 254 254 254 254 254 044 044 044
254 254 254 254 254 254 254 254 254 254 254 254 254 044 044 044