254 254 254 254 254 254 254 254 254 254 254 254 254 044 044 044
251 242 254 240 251 251 251 131 131 131 131 251 251 044 044 044
251 251 251 251 251 251 251 131 131 131 131 251 251 044 044 044
251 251 251 251 267 251 251 251 251 251 251 251 251 044 044 044
251 251 267 251 251 251 251 251 251 251 251 251 003 044 044 044
251 251 251 251 251 008 009 251 251 251 251 003 044 044 044 044
251 251 267 251 251 018 019 251 251 251 003 044 044 044 044 044
251 251 251 251 251 251 251 251 251 003 044 044 044 044 044 044
044 044 044 005 251 251 251 251 003 044 044 044 044 044 044 044
044 044 044 044 044 044 044 044 044 044 044 044 044 044 044 044
044 044 044 044 044 044 044 044 044 044 044 044 044 044 044 044